ailimitter	A.I.リミッター	0
bauxite	ボーキサイト	1
cable	ケーブル	0
cateriumingot	カテリウムインゴット	0
cateriumore	カテリウム鉱石	1
circuitboard	回路基盤	0
coal	石炭	1
computer	コンピューター	0
concrete	コンクリート	0
copperingot	銅インゴット	0
copperore	銅鉱石	1
crudeoil	石油	1
encasedindustrialbeam	梱包済工業用梁(Encased Industrial Beam)	0
fuel	燃料	0
heavymodularframe	ヘビーモジュラーフレーム	0
highspeedconnector	高速コネクター	0
ironingot	鉄インゴット	0
ironore	鉄鉱石	1
ironplate	鉄板	0
ironrod	鉄棒	0
limestone	石灰石	1
modularframe	モジュラーフレーム	0
motor	モーター	0
plastic	プラスチック	0
quickwire	クイックワイヤー	0
rawquartz	生水晶	1
reinforcedironplate	強化鉄板	0
rotor	ローター	0
rubber	ゴム	0
samore	S.A.M鉱石	1
screw	ネジ	0
silica	シリカ	1
stator	固定子	0
steelbeam	鉄骨	0
steelingot	鋼インゴット	0
steelpipe	鋼パイプ	0
sulfur	硫黄	1
supercomputer	スーパーコンピューター	0
uranium	ウラニウム鉱石	1
wire	銅線	0
